#,Name,Type 1,Type 2,Total,HP,Attack,Defense,Sp. Atk,Sp. Def,Generation,Legendary,Total
1,Bulbasaur,Grass,Poison,94,45,49,49,65,65,1,False,94
2,Ivysaur,Grass,Poison,122,60,62,63,80,80,1,False,122
3,Venusaur,Grass,Poison,162,80,82,83,100,100,1,False,162
3,VenusaurMega Venusaur,Grass,Poison,180,80,100,123,122,120,1,False,180
4,Charmander,Fire,,91,39,52,43,60,50,1,False,91
5,Charmeleon,Fire,,122,58,64,58,80,65,1,False,122
6,Charizard,Fire,Flying,162,78,84,78,109,85,1,False,162
6,CharizardMega Charizard X,Fire,Dragon,208,78,130,111,130,85,1,False,208
6,CharizardMega Charizard Y,Fire,Flying,182,78,104,78,159,115,1,False,182
7,Squirtle,Water,,92,44,48,65,50,64,1,False,92
8,Wartortle,Water,,122,59,63,80,65,80,1,False,122
9,Blastoise,Water,,162,79,83,100,85,105,1,False,162
9,BlastoiseMega Blastoise,Water,,182,79,103,120,135,115,1,False,182
10,Caterpie,Bug,,75,45,30,35,20,20,1,False,75
11,Metapod,Bug,,70,50,20,55,25,25,1,False,70
12,Butterfree,Bug,Flying,105,60,45,50,90,80,1,False,105
13,Weedle,Bug,Poison,75,40,35,30,20,20,1,False,75
14,Kakuna,Bug,Poison,70,45,25,50,25,25,1,False,70
15,Beedrill,Bug,Poison,155,65,90,40,45,80,1,False,155
15,BeedrillMega Beedrill,Bug,Poison,215,65,150,40,15,80,1,False,215
16,Pidgey,Normal,Flying,85,40,45,40,35,35,1,False,85
17,Pidgeotto,Normal,Flying,123,63,60,55,50,50,1,False,123
18,Pidgeot,Normal,Flying,163,83,80,75,70,70,1,False,163
18,PidgeotMega Pidgeot,Normal,Flying,163,83,80,80,135,80,1,False,163
19,Rattata,Normal,,86,30,56,35,25,35,1,False,86
20,Raticate,Normal,,136,55,81,60,50,70,1,False,136
21,Spearow,Normal,Flying,100,40,60,30,31,31,1,False,100
22,Fearow,Normal,Flying,155,65,90,65,61,61,1,False,155
23,Ekans,Poison,,95,35,60,44,40,54,1,False,95
24,Arbok,Poison,,145,60,85,69,65,79,1,False,145
25,Pikachu,Electric,,90,35,55,40,50,50,1,False,90
26,Raichu,Electric,,150,60,90,55,90,80,1,False,150
27,Sandshrew,Ground,,125,50,75,85,20,30,1,False,125
28,Sandslash,Ground,,175,75,100,110,45,55,1,False,175
29,Nidoran (Female),Poison,,102,55,47,52,40,40,1,False,102
30,Nidorina,Poison,,132,70,62,67,55,55,1,False,132
31,Nidoqueen,Poison,Ground,182,90,92,87,75,85,1,False,182
32,Nidoran (Male),Poison,,103,46,57,40,40,40,1,False,103
33,Nidorino,Poison,,133,61,72,57,55,55,1,False,133
34,Nidoking,Poison,Ground,183,81,102,77,85,75,1,False,183
35,Clefairy,Fairy,,115,70,45,48,60,65,1,False,115
36,Clefable,Fairy,,165,95,70,73,95,90,1,False,165
37,Vulpix,Fire,,79,38,41,40,50,65,1,False,79
38,Ninetales,Fire,,149,73,76,75,81,100,1,False,149
39,Jigglypuff,Normal,Fairy,160,115,45,20,45,25,1,False,160
40,Wigglytuff,Normal,Fairy,210,140,70,45,85,50,1,False,210
41,Zubat,Poison,Flying,85,40,45,35,30,40,1,False,85
42,Golbat,Poison,Flying,155,75,80,70,65,75,1,False,155
43,Oddish,Grass,Poison,95,45,50,55,75,65,1,False,95
44,Gloom,Grass,Poison,125,60,65,70,85,75,1,False,125
45,Vileplume,Grass,Poison,155,75,80,85,110,90,1,False,155
46,Paras,Bug,Grass,105,35,70,55,45,55,1,False,105
47,Parasect,Bug,Grass,155,60,95,80,60,80,1,False,155
48,Venonat,Bug,Poison,115,60,55,50,40,55,1,False,115
49,Venomoth,Bug,Poison,135,70,65,60,90,75,1,False,135
50,Diglett,Ground,,65,10,55,25,35,45,1,False,65
51,Dugtrio,Ground,,115,35,80,50,50,70,1,False,115
52,Meowth,Normal,,85,40,45,35,40,40,1,False,85
53,Persian,Normal,,135,65,70,60,65,65,1,False,135
54,Psyduck,Water,,102,50,52,48,65,50,1,False,102
55,Golduck,Water,,162,80,82,78,95,80,1,False,162
56,Mankey,Fighting,,120,40,80,35,35,45,1,False,120
57,Primeape,Fighting,,170,65,105,60,60,70,1,False,170
58,Growlithe,Fire,,125,55,70,45,70,50,1,False,125
59,Arcanine,Fire,,200,90,110,80,100,80,1,False,200
60,Poliwag,Water,,90,40,50,40,40,40,1,False,90
61,Poliwhirl,Water,,130,65,65,65,50,50,1,False,130
62,Poliwrath,Water,Fighting,185,90,95,95,70,90,1,False,185
63,Abra,Psychic,,45,25,20,15,105,55,1,False,45
64,Kadabra,Psychic,,75,40,35,30,120,70,1,False,75
65,Alakazam,Psychic,,105,55,50,45,135,95,1,False,105
65,AlakazamMega Alakazam,Psychic,,105,55,50,65,175,95,1,False,105
66,Machop,Fighting,,150,70,80,50,35,35,1,False,150
67,Machoke,Fighting,,180,80,100,70,50,60,1,False,180
68,Machamp,Fighting,,220,90,130,80,65,85,1,False,220
69,Bellsprout,Grass,Poison,125,50,75,35,70,30,1,False,125
70,Weepinbell,Grass,Poison,155,65,90,50,85,45,1,False,155
71,Victreebel,Grass,Poison,185,80,105,65,100,70,1,False,185
72,Tentacool,Water,Poison,80,40,40,35,50,100,1,False,80
73,Tentacruel,Water,Poison,150,80,70,65,80,120,1,False,150
74,Geodude,Rock,Ground,120,40,80,100,30,30,1,False,120
75,Graveler,Rock,Ground,150,55,95,115,45,45,1,False,150
76,Golem,Rock,Ground,200,80,120,130,55,65,1,False,200
77,Ponyta,Fire,,135,50,85,55,65,65,1,False,135
78,Rapidash,Fire,,165,65,100,70,80,80,1,False,165
79,Slowpoke,Water,Psychic,155,90,65,65,40,40,1,False,155
80,Slowbro,Water,Psychic,170,95,75,110,100,80,1,False,170
80,SlowbroMega Slowbro,Water,Psychic,170,95,75,180,130,80,1,False,170
81,Magnemite,Electric,Steel,60,25,35,70,95,55,1,False,60
82,Magneton,Electric,Steel,110,50,60,95,120,70,1,False,110
83,Farfetch'd,Normal,Flying,117,52,65,55,58,62,1,False,117
84,Doduo,Normal,Flying,120,35,85,45,35,35,1,False,120
85,Dodrio,Normal,Flying,170,60,110,70,60,60,1,False,170
86,Seel,Water,,110,65,45,55,45,70,1,False,110
87,Dewgong,Water,Ice,160,90,70,80,70,95,1,False,160
88,Grimer,Poison,,160,80,80,50,40,50,1,False,160
89,Muk,Poison,,210,105,105,75,65,100,1,False,210
90,Shellder,Water,,95,30,65,100,45,25,1,False,95
91,Cloyster,Water,Ice,145,50,95,180,85,45,1,False,145
92,Gastly,Ghost,Poison,65,30,35,30,100,35,1,False,65
93,Haunter,Ghost,Poison,95,45,50,45,115,55,1,False,95
94,Gengar,Ghost,Poison,125,60,65,60,130,75,1,False,125
94,GengarMega Gengar,Ghost,Poison,125,60,65,80,170,95,1,False,125
95,Onix,Rock,Ground,80,35,45,160,30,45,1,False,80
96,Drowzee,Psychic,,108,60,48,45,43,90,1,False,108
97,Hypno,Psychic,,158,85,73,70,73,115,1,False,158
98,Krabby,Water,,135,30,105,90,25,25,1,False,135
99,Kingler,Water,,185,55,130,115,50,50,1,False,185
100,Voltorb,Electric,,70,40,30,50,55,55,1,False,70
101,Electrode,Electric,,110,60,50,70,80,80,1,False,110
102,Exeggcute,Grass,Psychic,100,60,40,80,60,45,1,False,100
103,Exeggutor,Grass,Psychic,190,95,95,85,125,65,1,False,190
104,Cubone,Ground,,100,50,50,95,40,50,1,False,100
105,Marowak,Ground,,140,60,80,110,50,80,1,False,140
106,Hitmonlee,Fighting,,170,50,120,53,35,110,1,False,170
107,Hitmonchan,Fighting,,155,50,105,79,35,110,1,False,155
108,Lickitung,Normal,,145,90,55,75,60,75,1,False,145
109,Koffing,Poison,,105,40,65,95,60,45,1,False,105
110,Weezing,Poison,,155,65,90,120,85,70,1,False,155
111,Rhyhorn,Ground,Rock,165,80,85,95,30,30,1,False,165
112,Rhydon,Ground,Rock,235,105,130,120,45,45,1,False,235
113,Chansey,Normal,,255,250,5,5,35,105,1,False,255
114,Tangela,Grass,,120,65,55,115,100,40,1,False,120
115,Kangaskhan,Normal,,200,105,95,80,40,80,1,False,200
115,KangaskhanMega Kangaskhan,Normal,,230,105,125,100,60,100,1,False,230
116,Horsea,Water,,70,30,40,70,70,25,1,False,70
117,Seadra,Water,,120,55,65,95,95,45,1,False,120
118,Goldeen,Water,,112,45,67,60,35,50,1,False,112
119,Seaking,Water,,172,80,92,65,65,80,1,False,172
120,Staryu,Water,,75,30,45,55,70,55,1,False,75
121,Starmie,Water,Psychic,135,60,75,85,100,85,1,False,135
122,Mr. Mime,Psychic,Fairy,85,40,45,65,100,120,1,False,85
123,Scyther,Bug,Flying,180,70,110,80,55,80,1,False,180
124,Jynx,Ice,Psychic,115,65,50,35,115,95,1,False,115
125,Electabuzz,Electric,,148,65,83,57,95,85,1,False,148
126,Magmar,Fire,,160,65,95,57,100,85,1,False,160
127,Pinsir,Bug,,190,65,125,100,55,70,1,False,190
127,PinsirMega Pinsir,Bug,Flying,220,65,155,120,65,90,1,False,220
128,Tauros,Normal,,175,75,100,95,40,70,1,False,175
129,Magikarp,Water,,30,20,10,55,15,20,1,False,30
130,Gyarados,Water,Flying,220,95,125,79,60,100,1,False,220
130,GyaradosMega Gyarados,Water,Dark,250,95,155,109,70,130,1,False,250
131,Lapras,Water,Ice,215,130,85,80,85,95,1,False,215
132,Ditto,Normal,,96,48,48,48,48,48,1,False,96
133,Eevee,Normal,,110,55,55,50,45,65,1,False,110
134,Vaporeon,Water,,195,130,65,60,110,95,1,False,195
135,Jolteon,Electric,,130,65,65,60,110,95,1,False,130
136,Flareon,Fire,,195,65,130,60,95,110,1,False,195
137,Porygon,Normal,,125,65,60,70,85,75,1,False,125
138,Omanyte,Rock,Water,75,35,40,100,90,55,1,False,75
139,Omastar,Rock,Water,130,70,60,125,115,70,1,False,130
140,Kabuto,Rock,Water,110,30,80,90,55,45,1,False,110
141,Kabutops,Rock,Water,175,60,115,105,65,70,1,False,175
142,Aerodactyl,Rock,Flying,185,80,105,65,60,75,1,False,185
142,AerodactylMega Aerodactyl,Rock,Flying,215,80,135,85,70,95,1,False,215
143,Snorlax,Normal,,270,160,110,65,65,110,1,False,270
144,Articuno,Ice,Flying,175,90,85,100,95,125,1,True,175
145,Zapdos,Electric,Flying,180,90,90,85,125,90,1,True,180
146,Moltres,Fire,Flying,190,90,100,90,125,85,1,True,190
147,Dratini,Dragon,,105,41,64,45,50,50,1,False,105
148,Dragonair,Dragon,,145,61,84,65,70,70,1,False,145
149,Dragonite,Dragon,Flying,225,91,134,95,100,100,1,False,225
150,Mewtwo,Psychic,,216,106,110,90,154,90,1,True,216
150,MewtwoMega Mewtwo X,Psychic,Fighting,296,106,190,100,154,100,1,True,296
150,MewtwoMega Mewtwo Y,Psychic,,256,106,150,70,194,120,1,True,256
151,Mew,Psychic,,200,100,100,100,100,100,1,False,200
152,Chikorita,Grass,,94,45,49,65,49,65,2,False,94
153,Bayleef,Grass,,122,60,62,80,63,80,2,False,122
154,Meganium,Grass,,162,80,82,100,83,100,2,False,162
155,Cyndaquil,Fire,,91,39,52,43,60,50,2,False,91
156,Quilava,Fire,,122,58,64,58,80,65,2,False,122
157,Typhlosion,Fire,,162,78,84,78,109,85,2,False,162
158,Totodile,Water,,115,50,65,64,44,48,2,False,115
159,Croconaw,Water,,145,65,80,80,59,63,2,False,145
160,Feraligatr,Water,,190,85,105,100,79,83,2,False,190
161,Sentret,Normal,,81,35,46,34,35,45,2,False,81
162,Furret,Normal,,161,85,76,64,45,55,2,False,161
163,Hoothoot,Normal,Flying,90,60,30,30,36,56,2,False,90
164,Noctowl,Normal,Flying,150,100,50,50,76,96,2,False,150
165,Ledyba,Bug,Flying,60,40,20,30,40,80,2,False,60
166,Ledian,Bug,Flying,90,55,35,50,55,110,2,False,90
167,Spinarak,Bug,Poison,100,40,60,40,40,40,2,False,100
168,Ariados,Bug,Poison,160,70,90,70,60,60,2,False,160
169,Crobat,Poison,Flying,175,85,90,80,70,80,2,False,175
170,Chinchou,Water,Electric,113,75,38,38,56,56,2,False,113
171,Lanturn,Water,Electric,183,125,58,58,76,76,2,False,183
172,Pichu,Electric,,60,20,40,15,35,35,2,False,60
173,Cleffa,Fairy,,75,50,25,28,45,55,2,False,75
174,Igglybuff,Normal,Fairy,120,90,30,15,40,20,2,False,120
175,Togepi,Fairy,,55,35,20,65,40,65,2,False,55
176,Togetic,Fairy,Flying,95,55,40,85,80,105,2,False,95
177,Natu,Psychic,Flying,90,40,50,45,70,45,2,False,90
178,Xatu,Psychic,Flying,140,65,75,70,95,70,2,False,140
179,Mareep,Electric,,95,55,40,40,65,45,2,False,95
180,Flaaffy,Electric,,125,70,55,55,80,60,2,False,125
181,Ampharos,Electric,,165,90,75,85,115,90,2,False,165
181,AmpharosMega Ampharos,Electric,Dragon,185,90,95,105,165,110,2,False,185
182,Bellossom,Grass,,155,75,80,95,90,100,2,False,155
183,Marill,Water,Fairy,90,70,20,50,20,50,2,False,90
184,Azumarill,Water,Fairy,150,100,50,80,60,80,2,False,150
185,Sudowoodo,Rock,,170,70,100,115,30,65,2,False,170
186,Politoed,Water,,165,90,75,75,90,100,2,False,165
187,Hoppip,Grass,Flying,70,35,35,40,35,55,2,False,70
188,Skiploom,Grass,Flying,100,55,45,50,45,65,2,False,100
189,Jumpluff,Grass,Flying,130,75,55,70,55,95,2,False,130
190,Aipom,Normal,,125,55,70,55,40,55,2,False,125
191,Sunkern,Grass,,60,30,30,30,30,30,2,False,60
192,Sunflora,Grass,,150,75,75,55,105,85,2,False,150
193,Yanma,Bug,Flying,130,65,65,45,75,45,2,False,130
194,Wooper,Water,Ground,100,55,45,45,25,25,2,False,100
195,Quagsire,Water,Ground,180,95,85,85,65,65,2,False,180
196,Espeon,Psychic,,130,65,65,60,130,95,2,False,130
197,Umbreon,Dark,,160,95,65,110,60,130,2,False,160
198,Murkrow,Dark,Flying,145,60,85,42,85,42,2,False,145
199,Slowking,Water,Psychic,170,95,75,80,100,110,2,False,170
200,Misdreavus,Ghost,,120,60,60,60,85,85,2,False,120
201,Unown,Psychic,,120,48,72,48,72,48,2,False,120
202,Wobbuffet,Psychic,,223,190,33,58,33,58,2,False,223
203,Girafarig,Normal,Psychic,150,70,80,65,90,65,2,False,150
204,Pineco,Bug,,115,50,65,90,35,35,2,False,115
205,Forretress,Bug,Steel,165,75,90,140,60,60,2,False,165
206,Dunsparce,Normal,,170,100,70,70,65,65,2,False,170
207,Gligar,Ground,Flying,140,65,75,105,35,65,2,False,140
208,Steelix,Steel,Ground,160,75,85,200,55,65,2,False,160
208,SteelixMega Steelix,Steel,Ground,200,75,125,230,55,95,2,False,200
209,Snubbull,Fairy,,140,60,80,50,40,40,2,False,140
210,Granbull,Fairy,,210,90,120,75,60,60,2,False,210
211,Qwilfish,Water,Poison,160,65,95,75,55,55,2,False,160
212,Scizor,Bug,Steel,200,70,130,100,55,80,2,False,200
212,ScizorMega Scizor,Bug,Steel,220,70,150,140,65,100,2,False,220
213,Shuckle,Bug,Rock,30,20,10,230,10,230,2,False,30
214,Heracross,Bug,Fighting,205,80,125,75,40,95,2,False,205
214,HeracrossMega Heracross,Bug,Fighting,265,80,185,115,40,105,2,False,265
215,Sneasel,Dark,Ice,150,55,95,55,35,75,2,False,150
216,Teddiursa,Normal,,140,60,80,50,50,50,2,False,140
217,Ursaring,Normal,,220,90,130,75,75,75,2,False,220
218,Slugma,Fire,,80,40,40,40,70,40,2,False,80
219,Magcargo,Fire,Rock,100,50,50,120,80,80,2,False,100
220,Swinub,Ice,Ground,100,50,50,40,30,30,2,False,100
221,Piloswine,Ice,Ground,200,100,100,80,60,60,2,False,200
222,Corsola,Water,Rock,110,55,55,85,65,85,2,False,110
223,Remoraid,Water,,100,35,65,35,65,35,2,False,100
224,Octillery,Water,,180,75,105,75,105,75,2,False,180
225,Delibird,Ice,Flying,100,45,55,45,65,45,2,False,100
226,Mantine,Water,Flying,105,65,40,70,80,140,2,False,105
227,Skarmory,Steel,Flying,145,65,80,140,40,70,2,False,145
228,Houndour,Dark,Fire,105,45,60,30,80,50,2,False,105
229,Houndoom,Dark,Fire,165,75,90,50,110,80,2,False,165
229,HoundoomMega Houndoom,Dark,Fire,165,75,90,90,140,90,2,False,165
230,Kingdra,Water,Dragon,170,75,95,95,95,95,2,False,170
231,Phanpy,Ground,,150,90,60,60,40,40,2,False,150
232,Donphan,Ground,,210,90,120,120,60,60,2,False,210
233,Porygon2,Normal,,165,85,80,90,105,95,2,False,165
234,Stantler,Normal,,168,73,95,62,85,65,2,False,168
235,Smeargle,Normal,,75,55,20,35,20,45,2,False,75
236,Tyrogue,Fighting,,70,35,35,35,35,35,2,False,70
237,Hitmontop,Fighting,,145,50,95,95,35,110,2,False,145
238,Smoochum,Ice,Psychic,75,45,30,15,85,65,2,False,75
239,Elekid,Electric,,108,45,63,37,65,55,2,False,108
240,Magby,Fire,,120,45,75,37,70,55,2,False,120
241,Miltank,Normal,,175,95,80,105,40,70,2,False,175
242,Blissey,Normal,,265,255,10,10,75,135,2,False,265
243,Raikou,Electric,,175,90,85,75,115,100,2,True,175
244,Entei,Fire,,230,115,115,85,90,75,2,True,230
245,Suicune,Water,,175,100,75,115,90,115,2,True,175
246,Larvitar,Rock,Ground,114,50,64,50,45,50,2,False,114
247,Pupitar,Rock,Ground,154,70,84,70,65,70,2,False,154
248,Tyranitar,Rock,Dark,234,100,134,110,95,100,2,False,234
248,TyranitarMega Tyranitar,Rock,Dark,264,100,164,150,95,120,2,False,264
249,Lugia,Psychic,Flying,196,106,90,130,90,154,2,True,196
250,Ho-oh,Fire,Flying,236,106,130,90,110,154,2,True,236
251,Celebi,Psychic,Grass,200,100,100,100,100,100,2,False,200
252,Treecko,Grass,,85,40,45,35,65,55,3,False,85
253,Grovyle,Grass,,115,50,65,45,85,65,3,False,115
254,Sceptile,Grass,,155,70,85,65,105,85,3,False,155
254,SceptileMega Sceptile,Grass,Dragon,180,70,110,75,145,85,3,False,180
255,Torchic,Fire,,105,45,60,40,70,50,3,False,105
256,Combusken,Fire,Fighting,145,60,85,60,85,60,3,False,145
257,Blaziken,Fire,Fighting,200,80,120,70,110,70,3,False,200
257,BlazikenMega Blaziken,Fire,Fighting,240,80,160,80,130,80,3,False,240
258,Mudkip,Water,,120,50,70,50,50,50,3,False,120
259,Marshtomp,Water,Ground,155,70,85,70,60,70,3,False,155
260,Swampert,Water,Ground,210,100,110,90,85,90,3,False,210
260,SwampertMega Swampert,Water,Ground,250,100,150,110,95,110,3,False,250
261,Poochyena,Dark,,90,35,55,35,30,30,3,False,90
262,Mightyena,Dark,,160,70,90,70,60,60,3,False,160
263,Zigzagoon,Normal,,68,38,30,41,30,41,3,False,68
264,Linoone,Normal,,148,78,70,61,50,61,3,False,148
265,Wurmple,Bug,,90,45,45,35,20,30,3,False,90
266,Silcoon,Bug,,85,50,35,55,25,25,3,False,85
267,Beautifly,Bug,Flying,130,60,70,50,100,50,3,False,130
268,Cascoon,Bug,,85,50,35,55,25,25,3,False,85
269,Dustox,Bug,Poison,110,60,50,70,50,90,3,False,110
270,Lotad,Water,Grass,70,40,30,30,40,50,3,False,70
271,Lombre,Water,Grass,110,60,50,50,60,70,3,False,110
272,Ludicolo,Water,Grass,150,80,70,70,90,100,3,False,150
273,Seedot,Grass,,80,40,40,50,30,30,3,False,80
274,Nuzleaf,Grass,Dark,140,70,70,40,60,40,3,False,140
275,Shiftry,Grass,Dark,190,90,100,60,90,60,3,False,190
276,Taillow,Normal,Flying,95,40,55,30,30,30,3,False,95
277,Swellow,Normal,Flying,145,60,85,60,50,50,3,False,145
278,Wingull,Water,Flying,70,40,30,30,55,30,3,False,70
279,Pelipper,Water,Flying,110,60,50,100,85,70,3,False,110
280,Ralts,Psychic,Fairy,53,28,25,25,45,35,3,False,53
281,Kirlia,Psychic,Fairy,73,38,35,35,65,55,3,False,73
282,Gardevoir,Psychic,Fairy,133,68,65,65,125,115,3,False,133
282,GardevoirMega Gardevoir,Psychic,Fairy,153,68,85,65,165,135,3,False,153
283,Surskit,Bug,Water,70,40,30,32,50,52,3,False,70
284,Masquerain,Bug,Flying,130,70,60,62,80,82,3,False,130
285,Shroomish,Grass,,100,60,40,60,40,60,3,False,100
286,Breloom,Grass,Fighting,190,60,130,80,60,60,3,False,190
287,Slakoth,Normal,,120,60,60,60,35,35,3,False,120
288,Vigoroth,Normal,,160,80,80,80,55,55,3,False,160
289,Slaking,Normal,,310,150,160,100,95,65,3,False,310
290,Nincada,Bug,Ground,76,31,45,90,30,30,3,False,76
291,Ninjask,Bug,Flying,151,61,90,45,50,50,3,False,151
292,Shedinja,Bug,Ghost,91,1,90,45,30,30,3,False,91
293,Whismur,Normal,,115,64,51,23,51,23,3,False,115
294,Loudred,Normal,,155,84,71,43,71,43,3,False,155
295,Exploud,Normal,,195,104,91,63,91,73,3,False,195
296,Makuhita,Fighting,,132,72,60,30,20,30,3,False,132
297,Hariyama,Fighting,,264,144,120,60,40,60,3,False,264
298,Azurill,Normal,Fairy,70,50,20,40,20,40,3,False,70
299,Nosepass,Rock,,75,30,45,135,45,90,3,False,75
300,Skitty,Normal,,95,50,45,45,35,35,3,False,95
301,Delcatty,Normal,,135,70,65,65,55,55,3,False,135
302,Sableye,Dark,Ghost,125,50,75,75,65,65,3,False,125
302,SableyeMega Sableye,Dark,Ghost,135,50,85,125,85,115,3,False,135
303,Mawile,Steel,Fairy,135,50,85,85,55,55,3,False,135
303,MawileMega Mawile,Steel,Fairy,155,50,105,125,55,95,3,False,155
304,Aron,Steel,Rock,120,50,70,100,40,40,3,False,120
305,Lairon,Steel,Rock,150,60,90,140,50,50,3,False,150
306,Aggron,Steel,Rock,180,70,110,180,60,60,3,False,180
306,AggronMega Aggron,Steel,,210,70,140,230,60,80,3,False,210
307,Meditite,Fighting,Psychic,70,30,40,55,40,55,3,False,70
308,Medicham,Fighting,Psychic,120,60,60,75,60,75,3,False,120
308,MedichamMega Medicham,Fighting,Psychic,160,60,100,85,80,85,3,False,160
309,Electrike,Electric,,85,40,45,40,65,40,3,False,85
310,Manectric,Electric,,145,70,75,60,105,60,3,False,145
310,ManectricMega Manectric,Electric,,145,70,75,80,135,80,3,False,145
311,Plusle,Electric,,110,60,50,40,85,75,3,False,110
312,Minun,Electric,,100,60,40,50,75,85,3,False,100
313,Volbeat,Bug,,138,65,73,55,47,75,3,False,138
314,Illumise,Bug,,112,65,47,55,73,75,3,False,112
315,Roselia,Grass,Poison,110,50,60,45,100,80,3,False,110
316,Gulpin,Poison,,113,70,43,53,43,53,3,False,113
317,Swalot,Poison,,173,100,73,83,73,83,3,False,173
318,Carvanha,Water,Dark,135,45,90,20,65,20,3,False,135
319,Sharpedo,Water,Dark,190,70,120,40,95,40,3,False,190
319,SharpedoMega Sharpedo,Water,Dark,210,70,140,70,110,65,3,False,210
320,Wailmer,Water,,200,130,70,35,70,35,3,False,200
321,Wailord,Water,,260,170,90,45,90,45,3,False,260
322,Numel,Fire,Ground,120,60,60,40,65,45,3,False,120
323,Camerupt,Fire,Ground,170,70,100,70,105,75,3,False,170
323,CameruptMega Camerupt,Fire,Ground,190,70,120,100,145,105,3,False,190
324,Torkoal,Fire,,155,70,85,140,85,70,3,False,155
325,Spoink,Psychic,,85,60,25,35,70,80,3,False,85
326,Grumpig,Psychic,,125,80,45,65,90,110,3,False,125
327,Spinda,Normal,,120,60,60,60,60,60,3,False,120
328,Trapinch,Ground,,145,45,100,45,45,45,3,False,145
329,Vibrava,Ground,Dragon,120,50,70,50,50,50,3,False,120
330,Flygon,Ground,Dragon,180,80,100,80,80,80,3,False,180
331,Cacnea,Grass,,135,50,85,40,85,40,3,False,135
332,Cacturne,Grass,Dark,185,70,115,60,115,60,3,False,185
333,Swablu,Normal,Flying,85,45,40,60,40,75,3,False,85
334,Altaria,Dragon,Flying,145,75,70,90,70,105,3,False,145
334,AltariaMega Altaria,Dragon,Fairy,185,75,110,110,110,105,3,False,185
335,Zangoose,Normal,,188,73,115,60,60,60,3,False,188
336,Seviper,Poison,,173,73,100,60,100,60,3,False,173
337,Lunatone,Rock,Psychic,125,70,55,65,95,85,3,False,125
338,Solrock,Rock,Psychic,165,70,95,85,55,65,3,False,165
339,Barboach,Water,Ground,98,50,48,43,46,41,3,False,98
340,Whiscash,Water,Ground,188,110,78,73,76,71,3,False,188
341,Corphish,Water,,123,43,80,65,50,35,3,False,123
342,Crawdaunt,Water,Dark,183,63,120,85,90,55,3,False,183
343,Baltoy,Ground,Psychic,80,40,40,55,40,70,3,False,80
344,Claydol,Ground,Psychic,130,60,70,105,70,120,3,False,130
345,Lileep,Rock,Grass,107,66,41,77,61,87,3,False,107
346,Cradily,Rock,Grass,167,86,81,97,81,107,3,False,167
347,Anorith,Rock,Bug,140,45,95,50,40,50,3,False,140
348,Armaldo,Rock,Bug,200,75,125,100,70,80,3,False,200
349,Feebas,Water,,35,20,15,20,10,55,3,False,35
350,Milotic,Water,,155,95,60,79,100,125,3,False,155
351,Castform,Normal,,140,70,70,70,70,70,3,False,140
352,Kecleon,Normal,,150,60,90,70,60,120,3,False,150
353,Shuppet,Ghost,,119,44,75,35,63,33,3,False,119
354,Banette,Ghost,,179,64,115,65,83,63,3,False,179
354,BanetteMega Banette,Ghost,,229,64,165,75,93,83,3,False,229
355,Duskull,Ghost,,60,20,40,90,30,90,3,False,60
356,Dusclops,Ghost,,110,40,70,130,60,130,3,False,110
357,Tropius,Grass,Flying,167,99,68,83,72,87,3,False,167
358,Chimecho,Psychic,,115,65,50,70,95,80,3,False,115
359,Absol,Dark,,195,65,130,60,75,60,3,False,195
359,AbsolMega Absol,Dark,,215,65,150,60,115,60,3,False,215
360,Wynaut,Psychic,,118,95,23,48,23,48,3,False,118
361,Snorunt,Ice,,100,50,50,50,50,50,3,False,100
362,Glalie,Ice,,160,80,80,80,80,80,3,False,160
362,GlalieMega Glalie,Ice,,200,80,120,80,120,80,3,False,200
363,Spheal,Ice,Water,110,70,40,50,55,50,3,False,110
364,Sealeo,Ice,Water,150,90,60,70,75,70,3,False,150
365,Walrein,Ice,Water,190,110,80,90,95,90,3,False,190
366,Clamperl,Water,,99,35,64,85,74,55,3,False,99
367,Huntail,Water,,159,55,104,105,94,75,3,False,159
368,Gorebyss,Water,,139,55,84,105,114,75,3,False,139
369,Relicanth,Water,Rock,190,100,90,130,45,65,3,False,190
370,Luvdisc,Water,,73,43,30,55,40,65,3,False,73
371,Bagon,Dragon,,120,45,75,60,40,30,3,False,120
372,Shelgon,Dragon,,160,65,95,100,60,50,3,False,160
373,Salamence,Dragon,Flying,230,95,135,80,110,80,3,False,230
373,SalamenceMega Salamence,Dragon,Flying,240,95,145,130,120,90,3,False,240
374,Beldum,Steel,Psychic,95,40,55,80,35,60,3,False,95
375,Metang,Steel,Psychic,135,60,75,100,55,80,3,False,135
376,Metagross,Steel,Psychic,215,80,135,130,95,90,3,False,215
376,MetagrossMega Metagross,Steel,Psychic,225,80,145,150,105,110,3,False,225
377,Regirock,Rock,,180,80,100,200,50,100,3,True,180
378,Regice,Ice,,130,80,50,100,100,200,3,True,130
379,Registeel,Steel,,155,80,75,150,75,150,3,True,155
380,Latias,Dragon,Psychic,160,80,80,90,110,130,3,True,160
380,LatiasMega Latias,Dragon,Psychic,180,80,100,120,140,150,3,True,180
381,Latios,Dragon,Psychic,170,80,90,80,130,110,3,True,170
381,LatiosMega Latios,Dragon,Psychic,210,80,130,100,160,120,3,True,210
382,Kyogre,Water,,200,100,100,90,150,140,3,True,200
382,KyogrePrimal Kyogre,Water,,250,100,150,90,180,160,3,True,250
383,Groudon,Ground,,250,100,150,140,100,90,3,True,250
383,GroudonPrimal Groudon,Ground,Fire,280,100,180,160,150,90,3,True,280
384,Rayquaza,Dragon,Flying,255,105,150,90,150,90,3,True,255
384,RayquazaMega Rayquaza,Dragon,Flying,285,105,180,100,180,100,3,True,285
385,Jirachi,Steel,Psychic,200,100,100,100,100,100,3,True,200
386,DeoxysNormal Forme,Psychic,,200,50,150,50,150,50,3,True,200
386,DeoxysAttack Forme,Psychic,,230,50,180,20,180,20,3,True,230
386,DeoxysDefense Forme,Psychic,,120,50,70,160,70,160,3,True,120
386,DeoxysSpeed Forme,Psychic,,145,50,95,90,95,90,3,True,145
387,Turtwig,Grass,,123,55,68,64,45,55,4,False,123
388,Grotle,Grass,,164,75,89,85,55,65,4,False,164
389,Torterra,Grass,Ground,204,95,109,105,75,85,4,False,204
390,Chimchar,Fire,,102,44,58,44,58,44,4,False,102
391,Monferno,Fire,Fighting,142,64,78,52,78,52,4,False,142
392,Infernape,Fire,Fighting,180,76,104,71,104,71,4,False,180
393,Piplup,Water,,104,53,51,53,61,56,4,False,104
394,Prinplup,Water,,130,64,66,68,81,76,4,False,130
395,Empoleon,Water,Steel,170,84,86,88,111,101,4,False,170
396,Starly,Normal,Flying,95,40,55,30,30,30,4,False,95
397,Staravia,Normal,Flying,130,55,75,50,40,40,4,False,130
398,Staraptor,Normal,Flying,205,85,120,70,50,60,4,False,205
399,Bidoof,Normal,,104,59,45,40,35,40,4,False,104
400,Bibarel,Normal,Water,164,79,85,60,55,60,4,False,164
401,Kricketot,Bug,,62,37,25,41,25,41,4,False,62
402,Kricketune,Bug,,162,77,85,51,55,51,4,False,162
403,Shinx,Electric,,110,45,65,34,40,34,4,False,110
404,Luxio,Electric,,145,60,85,49,60,49,4,False,145
405,Luxray,Electric,,200,80,120,79,95,79,4,False,200
406,Budew,Grass,Poison,70,40,30,35,50,70,4,False,70
407,Roserade,Grass,Poison,130,60,70,65,125,105,4,False,130
408,Cranidos,Rock,,192,67,125,40,30,30,4,False,192
409,Rampardos,Rock,,262,97,165,60,65,50,4,False,262
410,Shieldon,Rock,Steel,72,30,42,118,42,88,4,False,72
411,Bastiodon,Rock,Steel,112,60,52,168,47,138,4,False,112
412,Burmy,Bug,,69,40,29,45,29,45,4,False,69
413,WormadamPlant Cloak,Bug,Grass,119,60,59,85,79,105,4,False,119
413,WormadamSandy Cloak,Bug,Ground,139,60,79,105,59,85,4,False,139
413,WormadamTrash Cloak,Bug,Steel,129,60,69,95,69,95,4,False,129
414,Mothim,Bug,Flying,164,70,94,50,94,50,4,False,164
415,Combee,Bug,Flying,60,30,30,42,30,42,4,False,60
416,Vespiquen,Bug,Flying,150,70,80,102,80,102,4,False,150
417,Pachirisu,Electric,,105,60,45,70,45,90,4,False,105
418,Buizel,Water,,120,55,65,35,60,30,4,False,120
419,Floatzel,Water,,190,85,105,55,85,50,4,False,190
420,Cherubi,Grass,,80,45,35,45,62,53,4,False,80
421,Cherrim,Grass,,130,70,60,70,87,78,4,False,130
422,Shellos,Water,,124,76,48,48,57,62,4,False,124
423,Gastrodon,Water,Ground,194,111,83,68,92,82,4,False,194
424,Ambipom,Normal,,175,75,100,66,60,66,4,False,175
425,Drifloon,Ghost,Flying,140,90,50,34,60,44,4,False,140
426,Drifblim,Ghost,Flying,230,150,80,44,90,54,4,False,230
427,Buneary,Normal,,121,55,66,44,44,56,4,False,121
428,Lopunny,Normal,,141,65,76,84,54,96,4,False,141
428,LopunnyMega Lopunny,Normal,Fighting,201,65,136,94,54,96,4,False,201
429,Mismagius,Ghost,,120,60,60,60,105,105,4,False,120
430,Honchkrow,Dark,Flying,225,100,125,52,105,52,4,False,225
431,Glameow,Normal,,104,49,55,42,42,37,4,False,104
432,Purugly,Normal,,153,71,82,64,64,59,4,False,153
433,Chingling,Psychic,,75,45,30,50,65,50,4,False,75
434,Stunky,Poison,Dark,126,63,63,47,41,41,4,False,126
435,Skuntank,Poison,Dark,196,103,93,67,71,61,4,False,196
436,Bronzor,Steel,Psychic,81,57,24,86,24,86,4,False,81
437,Bronzong,Steel,Psychic,156,67,89,116,79,116,4,False,156
438,Bonsly,Rock,,130,50,80,95,10,45,4,False,130
439,Mime Jr.,Psychic,Fairy,45,20,25,45,70,90,4,False,45
440,Happiny,Normal,,105,100,5,5,15,65,4,False,105
441,Chatot,Normal,Flying,141,76,65,45,92,42,4,False,141
442,Spiritomb,Ghost,Dark,142,50,92,108,92,108,4,False,142
443,Gible,Dragon,Ground,128,58,70,45,40,45,4,False,128
444,Gabite,Dragon,Ground,158,68,90,65,50,55,4,False,158
445,Garchomp,Dragon,Ground,238,108,130,95,80,85,4,False,238
445,GarchompMega Garchomp,Dragon,Ground,278,108,170,115,120,95,4,False,278
446,Munchlax,Normal,,220,135,85,40,40,85,4,False,220
447,Riolu,Fighting,,110,40,70,40,35,40,4,False,110
448,Lucario,Fighting,Steel,180,70,110,70,115,70,4,False,180
448,LucarioMega Lucario,Fighting,Steel,215,70,145,88,140,70,4,False,215
449,Hippopotas,Ground,,140,68,72,78,38,42,4,False,140
450,Hippowdon,Ground,,220,108,112,118,68,72,4,False,220
451,Skorupi,Poison,Bug,90,40,50,90,30,55,4,False,90
452,Drapion,Poison,Dark,160,70,90,110,60,75,4,False,160
453,Croagunk,Poison,Fighting,109,48,61,40,61,40,4,False,109
454,Toxicroak,Poison,Fighting,189,83,106,65,86,65,4,False,189
455,Carnivine,Grass,,174,74,100,72,90,72,4,False,174
456,Finneon,Water,,98,49,49,56,49,61,4,False,98
457,Lumineon,Water,,138,69,69,76,69,86,4,False,138
458,Mantyke,Water,Flying,65,45,20,50,60,120,4,False,65
459,Snover,Grass,Ice,122,60,62,50,62,60,4,False,122
460,Abomasnow,Grass,Ice,182,90,92,75,92,85,4,False,182
460,AbomasnowMega Abomasnow,Grass,Ice,222,90,132,105,132,105,4,False,222
461,Weavile,Dark,Ice,190,70,120,65,45,85,4,False,190
462,Magnezone,Electric,Steel,140,70,70,115,130,90,4,False,140
463,Lickilicky,Normal,,195,110,85,95,80,95,4,False,195
464,Rhyperior,Ground,Rock,255,115,140,130,55,55,4,False,255
465,Tangrowth,Grass,,200,100,100,125,110,50,4,False,200
466,Electivire,Electric,,198,75,123,67,95,85,4,False,198
467,Magmortar,Fire,,170,75,95,67,125,95,4,False,170
468,Togekiss,Fairy,Flying,135,85,50,95,120,115,4,False,135
469,Yanmega,Bug,Flying,162,86,76,86,116,56,4,False,162
470,Leafeon,Grass,,175,65,110,130,60,65,4,False,175
471,Glaceon,Ice,,125,65,60,110,130,95,4,False,125
472,Gliscor,Ground,Flying,170,75,95,125,45,75,4,False,170
473,Mamoswine,Ice,Ground,240,110,130,80,70,60,4,False,240
474,Porygon-Z,Normal,,165,85,80,70,135,75,4,False,165
475,Gallade,Psychic,Fighting,193,68,125,65,65,115,4,False,193
475,GalladeMega Gallade,Psychic,Fighting,233,68,165,95,65,115,4,False,233
476,Probopass,Rock,Steel,115,60,55,145,75,150,4,False,115
477,Dusknoir,Ghost,,145,45,100,135,65,135,4,False,145
478,Froslass,Ice,Ghost,150,70,80,70,80,70,4,False,150
479,Rotom,Electric,Ghost,100,50,50,77,95,77,4,False,100
479,RotomHeat Rotom,Electric,Fire,115,50,65,107,105,107,4,False,115
479,RotomWash Rotom,Electric,Water,115,50,65,107,105,107,4,False,115
479,RotomFrost Rotom,Electric,Ice,115,50,65,107,105,107,4,False,115
479,RotomFan Rotom,Electric,Flying,115,50,65,107,105,107,4,False,115
479,RotomMow Rotom,Electric,Grass,115,50,65,107,105,107,4,False,115
480,Uxie,Psychic,,150,75,75,130,75,130,4,True,150
481,Mesprit,Psychic,,185,80,105,105,105,105,4,True,185
482,Azelf,Psychic,,200,75,125,70,125,70,4,True,200
483,Dialga,Steel,Dragon,220,100,120,120,150,100,4,True,220
484,Palkia,Water,Dragon,210,90,120,100,150,120,4,True,210
485,Heatran,Fire,Steel,181,91,90,106,130,106,4,True,181
486,Regigigas,Normal,,270,110,160,110,80,110,4,True,270
487,GiratinaAltered Forme,Ghost,Dragon,250,150,100,120,100,120,4,True,250
487,GiratinaOrigin Forme,Ghost,Dragon,270,150,120,100,120,100,4,True,270
488,Cresselia,Psychic,,190,120,70,120,75,130,4,False,190
489,Phione,Water,,160,80,80,80,80,80,4,False,160
490,Manaphy,Water,,200,100,100,100,100,100,4,False,200
491,Darkrai,Dark,,160,70,90,90,135,90,4,True,160
492,ShayminLand Forme,Grass,,200,100,100,100,100,100,4,True,200
492,ShayminSky Forme,Grass,Flying,203,100,103,75,120,75,4,True,203
493,Arceus,Normal,,240,120,120,120,120,120,4,True,240
494,Victini,Psychic,Fire,200,100,100,100,100,100,5,True,200
495,Snivy,Grass,,90,45,45,55,45,55,5,False,90
496,Servine,Grass,,120,60,60,75,60,75,5,False,120
497,Serperior,Grass,,150,75,75,95,75,95,5,False,150
498,Tepig,Fire,,128,65,63,45,45,45,5,False,128
499,Pignite,Fire,Fighting,183,90,93,55,70,55,5,False,183
500,Emboar,Fire,Fighting,233,110,123,65,100,65,5,False,233
501,Oshawott,Water,,110,55,55,45,63,45,5,False,110
502,Dewott,Water,,150,75,75,60,83,60,5,False,150
503,Samurott,Water,,195,95,100,85,108,70,5,False,195
504,Patrat,Normal,,100,45,55,39,35,39,5,False,100
505,Watchog,Normal,,145,60,85,69,60,69,5,False,145
506,Lillipup,Normal,,105,45,60,45,25,45,5,False,105
507,Herdier,Normal,,145,65,80,65,35,65,5,False,145
508,Stoutland,Normal,,195,85,110,90,45,90,5,False,195
509,Purrloin,Dark,,91,41,50,37,50,37,5,False,91
510,Liepard,Dark,,152,64,88,50,88,50,5,False,152
511,Pansage,Grass,,103,50,53,48,53,48,5,False,103
512,Simisage,Grass,,173,75,98,63,98,63,5,False,173
513,Pansear,Fire,,103,50,53,48,53,48,5,False,103
514,Simisear,Fire,,173,75,98,63,98,63,5,False,173
515,Panpour,Water,,103,50,53,48,53,48,5,False,103
516,Simipour,Water,,173,75,98,63,98,63,5,False,173
517,Munna,Psychic,,101,76,25,45,67,55,5,False,101
518,Musharna,Psychic,,171,116,55,85,107,95,5,False,171
519,Pidove,Normal,Flying,105,50,55,50,36,30,5,False,105
520,Tranquill,Normal,Flying,139,62,77,62,50,42,5,False,139
521,Unfezant,Normal,Flying,195,80,115,80,65,55,5,False,195
522,Blitzle,Electric,,105,45,60,32,50,32,5,False,105
523,Zebstrika,Electric,,175,75,100,63,80,63,5,False,175
524,Roggenrola,Rock,,130,55,75,85,25,25,5,False,130
525,Boldore,Rock,,175,70,105,105,50,40,5,False,175
526,Gigalith,Rock,,220,85,135,130,60,80,5,False,220
527,Woobat,Psychic,Flying,100,55,45,43,55,43,5,False,100
528,Swoobat,Psychic,Flying,124,67,57,55,77,55,5,False,124
529,Drilbur,Ground,,145,60,85,40,30,45,5,False,145
530,Excadrill,Ground,Steel,245,110,135,60,50,65,5,False,245
531,Audino,Normal,,163,103,60,86,60,86,5,False,163
531,AudinoMega Audino,Normal,Fairy,163,103,60,126,80,126,5,False,163
532,Timburr,Fighting,,155,75,80,55,25,35,5,False,155
533,Gurdurr,Fighting,,190,85,105,85,40,50,5,False,190
534,Conkeldurr,Fighting,,245,105,140,95,55,65,5,False,245
535,Tympole,Water,,100,50,50,40,50,40,5,False,100
536,Palpitoad,Water,Ground,140,75,65,55,65,55,5,False,140
537,Seismitoad,Water,Ground,200,105,95,75,85,75,5,False,200
538,Throh,Fighting,,220,120,100,85,30,85,5,False,220
539,Sawk,Fighting,,200,75,125,75,30,75,5,False,200
540,Sewaddle,Bug,Grass,98,45,53,70,40,60,5,False,98
541,Swadloon,Bug,Grass,118,55,63,90,50,80,5,False,118
542,Leavanny,Bug,Grass,178,75,103,80,70,80,5,False,178
543,Venipede,Bug,Poison,75,30,45,59,30,39,5,False,75
544,Whirlipede,Bug,Poison,95,40,55,99,40,79,5,False,95
545,Scolipede,Bug,Poison,160,60,100,89,55,69,5,False,160
546,Cottonee,Grass,Fairy,67,40,27,60,37,50,5,False,67
547,Whimsicott,Grass,Fairy,127,60,67,85,77,75,5,False,127
548,Petilil,Grass,,80,45,35,50,70,50,5,False,80
549,Lilligant,Grass,,130,70,60,75,110,75,5,False,130
550,Basculin,Water,,162,70,92,65,80,55,5,False,162
551,Sandile,Ground,Dark,122,50,72,35,35,35,5,False,122
552,Krokorok,Ground,Dark,142,60,82,45,45,45,5,False,142
553,Krookodile,Ground,Dark,212,95,117,80,65,70,5,False,212
554,Darumaka,Fire,,160,70,90,45,15,45,5,False,160
555,DarmanitanStandard Mode,Fire,,245,105,140,55,30,55,5,False,245
555,DarmanitanZen Mode,Fire,Psychic,135,105,30,105,140,105,5,False,135
556,Maractus,Grass,,161,75,86,67,106,67,5,False,161
557,Dwebble,Bug,Rock,115,50,65,85,35,35,5,False,115
558,Crustle,Bug,Rock,165,70,95,125,65,75,5,False,165
559,Scraggy,Dark,Fighting,125,50,75,70,35,70,5,False,125
560,Scrafty,Dark,Fighting,155,65,90,115,45,115,5,False,155
561,Sigilyph,Psychic,Flying,130,72,58,80,103,80,5,False,130
562,Yamask,Ghost,,68,38,30,85,55,65,5,False,68
563,Cofagrigus,Ghost,,108,58,50,145,95,105,5,False,108
564,Tirtouga,Water,Rock,132,54,78,103,53,45,5,False,132
565,Carracosta,Water,Rock,182,74,108,133,83,65,5,False,182
566,Archen,Rock,Flying,167,55,112,45,74,45,5,False,167
567,Archeops,Rock,Flying,215,75,140,65,112,65,5,False,215
568,Trubbish,Poison,,100,50,50,62,40,62,5,False,100
569,Garbodor,Poison,,175,80,95,82,60,82,5,False,175
570,Zorua,Dark,,105,40,65,40,80,40,5,False,105
571,Zoroark,Dark,,165,60,105,60,120,60,5,False,165
572,Minccino,Normal,,105,55,50,40,40,40,5,False,105
573,Cinccino,Normal,,170,75,95,60,65,60,5,False,170
574,Gothita,Psychic,,75,45,30,50,55,65,5,False,75
575,Gothorita,Psychic,,105,60,45,70,75,85,5,False,105
576,Gothitelle,Psychic,,125,70,55,95,95,110,5,False,125
577,Solosis,Psychic,,75,45,30,40,105,50,5,False,75
578,Duosion,Psychic,,105,65,40,50,125,60,5,False,105
579,Reuniclus,Psychic,,175,110,65,75,125,85,5,False,175
580,Ducklett,Water,Flying,106,62,44,50,44,50,5,False,106
581,Swanna,Water,Flying,162,75,87,63,87,63,5,False,162
582,Vanillite,Ice,,86,36,50,50,65,60,5,False,86
583,Vanillish,Ice,,116,51,65,65,80,75,5,False,116
584,Vanilluxe,Ice,,166,71,95,85,110,95,5,False,166
585,Deerling,Normal,Grass,120,60,60,50,40,50,5,False,120
586,Sawsbuck,Normal,Grass,180,80,100,70,60,70,5,False,180
587,Emolga,Electric,Flying,130,55,75,60,75,60,5,False,130
588,Karrablast,Bug,,125,50,75,45,40,45,5,False,125
589,Escavalier,Bug,Steel,205,70,135,105,60,105,5,False,205
590,Foongus,Grass,Poison,124,69,55,45,55,55,5,False,124
591,Amoonguss,Grass,Poison,199,114,85,70,85,80,5,False,199
592,Frillish,Water,Ghost,95,55,40,50,65,85,5,False,95
593,Jellicent,Water,Ghost,160,100,60,70,85,105,5,False,160
594,Alomomola,Water,,240,165,75,80,40,45,5,False,240
595,Joltik,Bug,Electric,97,50,47,50,57,50,5,False,97
596,Galvantula,Bug,Electric,147,70,77,60,97,60,5,False,147
597,Ferroseed,Grass,Steel,94,44,50,91,24,86,5,False,94
598,Ferrothorn,Grass,Steel,168,74,94,131,54,116,5,False,168
599,Klink,Steel,,95,40,55,70,45,60,5,False,95
600,Klang,Steel,,140,60,80,95,70,85,5,False,140
601,Klinklang,Steel,,160,60,100,115,70,85,5,False,160
602,Tynamo,Electric,,90,35,55,40,45,40,5,False,90
603,Eelektrik,Electric,,150,65,85,70,75,70,5,False,150
604,Eelektross,Electric,,200,85,115,80,105,80,5,False,200
605,Elgyem,Psychic,,110,55,55,55,85,55,5,False,110
606,Beheeyem,Psychic,,150,75,75,75,125,95,5,False,150
607,Litwick,Ghost,Fire,80,50,30,55,65,55,5,False,80
608,Lampent,Ghost,Fire,100,60,40,60,95,60,5,False,100
609,Chandelure,Ghost,Fire,115,60,55,90,145,90,5,False,115
610,Axew,Dragon,,133,46,87,60,30,40,5,False,133
611,Fraxure,Dragon,,183,66,117,70,40,50,5,False,183
612,Haxorus,Dragon,,223,76,147,90,60,70,5,False,223
613,Cubchoo,Ice,,125,55,70,40,60,40,5,False,125
614,Beartic,Ice,,205,95,110,80,70,80,5,False,205
615,Cryogonal,Ice,,120,70,50,30,95,135,5,False,120
616,Shelmet,Bug,,90,50,40,85,40,65,5,False,90
617,Accelgor,Bug,,150,80,70,40,100,60,5,False,150
618,Stunfisk,Ground,Electric,175,109,66,84,81,99,5,False,175
619,Mienfoo,Fighting,,130,45,85,50,55,50,5,False,130
620,Mienshao,Fighting,,190,65,125,60,95,60,5,False,190
621,Druddigon,Dragon,,197,77,120,90,60,90,5,False,197
622,Golett,Ground,Ghost,133,59,74,50,35,50,5,False,133
623,Golurk,Ground,Ghost,213,89,124,80,55,80,5,False,213
624,Pawniard,Dark,Steel,130,45,85,70,40,40,5,False,130
625,Bisharp,Dark,Steel,190,65,125,100,60,70,5,False,190
626,Bouffalant,Normal,,205,95,110,95,40,95,5,False,205
627,Rufflet,Normal,Flying,153,70,83,50,37,50,5,False,153
628,Braviary,Normal,Flying,223,100,123,75,57,75,5,False,223
629,Vullaby,Dark,Flying,125,70,55,75,45,65,5,False,125
630,Mandibuzz,Dark,Flying,175,110,65,105,55,95,5,False,175
631,Heatmor,Fire,,182,85,97,66,105,66,5,False,182
632,Durant,Bug,Steel,167,58,109,112,48,48,5,False,167
633,Deino,Dark,Dragon,117,52,65,50,45,50,5,False,117
634,Zweilous,Dark,Dragon,157,72,85,70,65,70,5,False,157
635,Hydreigon,Dark,Dragon,197,92,105,90,125,90,5,False,197
636,Larvesta,Bug,Fire,140,55,85,55,50,55,5,False,140
637,Volcarona,Bug,Fire,145,85,60,65,135,105,5,False,145
638,Cobalion,Steel,Fighting,181,91,90,129,90,72,5,True,181
639,Terrakion,Rock,Fighting,220,91,129,90,72,90,5,True,220
640,Virizion,Grass,Fighting,181,91,90,72,90,129,5,True,181
641,TornadusIncarnate Forme,Flying,,194,79,115,70,125,80,5,True,194
641,TornadusTherian Forme,Flying,,179,79,100,80,110,90,5,True,179
642,ThundurusIncarnate Forme,Electric,Flying,194,79,115,70,125,80,5,True,194
642,ThundurusTherian Forme,Electric,Flying,184,79,105,70,145,80,5,True,184
643,Reshiram,Dragon,Fire,220,100,120,100,150,120,5,True,220
644,Zekrom,Dragon,Electric,250,100,150,120,120,100,5,True,250
645,LandorusIncarnate Forme,Ground,Flying,214,89,125,90,115,80,5,True,214
645,LandorusTherian Forme,Ground,Flying,234,89,145,90,105,80,5,True,234
646,Kyurem,Dragon,Ice,255,125,130,90,130,90,5,True,255
646,KyuremBlack Kyurem,Dragon,Ice,295,125,170,100,120,90,5,True,295
646,KyuremWhite Kyurem,Dragon,Ice,245,125,120,90,170,100,5,True,245
647,KeldeoOrdinary Forme,Water,Fighting,163,91,72,90,129,90,5,False,163
647,KeldeoResolute Forme,Water,Fighting,163,91,72,90,129,90,5,False,163
648,MeloettaAria Forme,Normal,Psychic,177,100,77,77,128,128,5,False,177
648,MeloettaPirouette Forme,Normal,Fighting,228,100,128,90,77,77,5,False,228
649,Genesect,Bug,Steel,191,71,120,95,120,95,5,False,191
650,Chespin,Grass,,117,56,61,65,48,45,6,False,117
651,Quilladin,Grass,,139,61,78,95,56,58,6,False,139
652,Chesnaught,Grass,Fighting,195,88,107,122,74,75,6,False,195
653,Fennekin,Fire,,85,40,45,40,62,60,6,False,85
654,Braixen,Fire,,118,59,59,58,90,70,6,False,118
655,Delphox,Fire,Psychic,144,75,69,72,114,100,6,False,144
656,Froakie,Water,,97,41,56,40,62,44,6,False,97
657,Frogadier,Water,,117,54,63,52,83,56,6,False,117
658,Greninja,Water,Dark,167,72,95,67,103,71,6,False,167
659,Bunnelby,Normal,,74,38,36,38,32,36,6,False,74
660,Diggersby,Normal,Ground,141,85,56,77,50,77,6,False,141
661,Fletchling,Normal,Flying,95,45,50,43,40,38,6,False,95
662,Fletchinder,Fire,Flying,135,62,73,55,56,52,6,False,135
663,Talonflame,Fire,Flying,159,78,81,71,74,69,6,False,159
664,Scatterbug,Bug,,73,38,35,40,27,25,6,False,73
665,Spewpa,Bug,,67,45,22,60,27,30,6,False,67
666,Vivillon,Bug,Flying,132,80,52,50,90,50,6,False,132
667,Litleo,Fire,Normal,112,62,50,58,73,54,6,False,112
668,Pyroar,Fire,Normal,154,86,68,72,109,66,6,False,154
669,Flabébé,Fairy,,82,44,38,39,61,79,6,False,82
670,Floette,Fairy,,99,54,45,47,75,98,6,False,99
671,Florges,Fairy,,143,78,65,68,112,154,6,False,143
672,Skiddo,Grass,,131,66,65,48,62,57,6,False,131
673,Gogoat,Grass,,223,123,100,62,97,81,6,False,223
674,Pancham,Fighting,,149,67,82,62,46,48,6,False,149
675,Pangoro,Fighting,Dark,219,95,124,78,69,71,6,False,219
676,Furfrou,Normal,,155,75,80,60,65,90,6,False,155
677,Espurr,Psychic,,110,62,48,54,63,60,6,False,110
678,MeowsticMale,Psychic,,122,74,48,76,83,81,6,False,122
678,MeowsticFemale,Psychic,,122,74,48,76,83,81,6,False,122
679,Honedge,Steel,Ghost,125,45,80,100,35,37,6,False,125
680,Doublade,Steel,Ghost,169,59,110,150,45,49,6,False,169
681,AegislashBlade Forme,Steel,Ghost,210,60,150,50,150,50,6,False,210
681,AegislashShield Forme,Steel,Ghost,110,60,50,150,50,150,6,False,110
682,Spritzee,Fairy,,130,78,52,60,63,65,6,False,130
683,Aromatisse,Fairy,,173,101,72,72,99,89,6,False,173
684,Swirlix,Fairy,,110,62,48,66,59,57,6,False,110
685,Slurpuff,Fairy,,162,82,80,86,85,75,6,False,162
686,Inkay,Dark,Psychic,107,53,54,53,37,46,6,False,107
687,Malamar,Dark,Psychic,178,86,92,88,68,75,6,False,178
688,Binacle,Rock,Water,94,42,52,67,39,56,6,False,94
689,Barbaracle,Rock,Water,177,72,105,115,54,86,6,False,177
690,Skrelp,Poison,Water,110,50,60,60,60,60,6,False,110
691,Dragalge,Poison,Dragon,140,65,75,90,97,123,6,False,140
692,Clauncher,Water,,103,50,53,62,58,63,6,False,103
693,Clawitzer,Water,,144,71,73,88,120,89,6,False,144
694,Helioptile,Electric,Normal,82,44,38,33,61,43,6,False,82
695,Heliolisk,Electric,Normal,117,62,55,52,109,94,6,False,117
696,Tyrunt,Rock,Dragon,147,58,89,77,45,45,6,False,147
697,Tyrantrum,Rock,Dragon,203,82,121,119,69,59,6,False,203
698,Amaura,Rock,Ice,136,77,59,50,67,63,6,False,136
699,Aurorus,Rock,Ice,200,123,77,72,99,92,6,False,200
700,Sylveon,Fairy,,160,95,65,65,110,130,6,False,160
701,Hawlucha,Fighting,Flying,170,78,92,75,74,63,6,False,170
702,Dedenne,Electric,Fairy,125,67,58,57,81,67,6,False,125
703,Carbink,Rock,Fairy,100,50,50,150,50,150,6,False,100
704,Goomy,Dragon,,95,45,50,35,55,75,6,False,95
705,Sliggoo,Dragon,,143,68,75,53,83,113,6,False,143
706,Goodra,Dragon,,190,90,100,70,110,150,6,False,190
707,Klefki,Steel,Fairy,137,57,80,91,80,87,6,False,137
708,Phantump,Ghost,Grass,113,43,70,48,50,60,6,False,113
709,Trevenant,Ghost,Grass,195,85,110,76,65,82,6,False,195
710,PumpkabooAverage Size,Ghost,Grass,115,49,66,70,44,55,6,False,115
710,PumpkabooSmall Size,Ghost,Grass,110,44,66,70,44,55,6,False,110
710,PumpkabooLarge Size,Ghost,Grass,120,54,66,70,44,55,6,False,120
710,PumpkabooSuper Size,Ghost,Grass,125,59,66,70,44,55,6,False,125
711,GourgeistAverage Size,Ghost,Grass,155,65,90,122,58,75,6,False,155
711,GourgeistSmall Size,Ghost,Grass,140,55,85,122,58,75,6,False,140
711,GourgeistLarge Size,Ghost,Grass,170,75,95,122,58,75,6,False,170
711,GourgeistSuper Size,Ghost,Grass,185,85,100,122,58,75,6,False,185
712,Bergmite,Ice,,124,55,69,85,32,35,6,False,124
713,Avalugg,Ice,,212,95,117,184,44,46,6,False,212
714,Noibat,Flying,Dragon,70,40,30,35,45,40,6,False,70
715,Noivern,Flying,Dragon,155,85,70,80,97,80,6,False,155
716,Xerneas,Fairy,,257,126,131,95,131,98,6,True,257
717,Yveltal,Dark,Flying,257,126,131,95,131,98,6,True,257
718,Zygarde50% Forme,Dragon,Ground,208,108,100,121,81,95,6,True,208
719,Diancie,Rock,Fairy,150,50,100,150,100,150,6,True,150
719,DiancieMega Diancie,Rock,Fairy,210,50,160,110,160,110,6,True,210
720,HoopaHoopa Confined,Psychic,Ghost,190,80,110,60,150,130,6,True,190
720,HoopaHoopa Unbound,Psychic,Dark,240,80,160,60,170,130,6,True,240
721,Volcanion,Fire,Water,190,80,110,120,130,90,6,True,190
